PPPPWWWWWPPPPWS
WWWPPPPPWPWWPWP
PPPPWPWPPPWPPPP
PWPWWPWPWWWPWWW
PWPWPPPPPPPPWPP
PPPWPWWWWPWWWPW
PWPPPPPWPPPPWPP
WWWWPWPWPWPPPPP
PPPPPPPPPWPWWPW
PWWWPWWWWWPPPPP
PWPWPWPPPWWWWWP
PPPWPPPWPPPPWPP
WWPWWWPWWWWPPPW
EWPPPWPWPPWWWPW
PPPWPWPPPWWPPPP
